##########      ## B
#  ####### #### ## #
## ##      #### ## #
##    #### #### ## #
## ####### ####    #
## ####### ####### #
      ############ #
##### #### ##      #
##### ##   ## ######
##### ## #### ######
#####      ##    ###
##### #### ##### ###
#  ## #### ### # ###
## ## #### ### # ###
## ## #### ### #####
   ####### ### #####
 ####          #####
 #### ### ##########
 #### ### ##########
A     ##############